%%%%%%%%%%
%P       % 
%     %% %
%   %%%% %
%   %%   %
%   %%   %
%   %%   %  
%   %%   %
%       N% 
%%%%%%%%%%